00000000
00000000
00000000c
00000000
00000000c
00000000
00000000c
00000000
00000000c
00000000
00000000
00000000
00000000
00000000c
00000000
11100000
00110000
00011000
00001100
00000220
00000033
00000005
00000111
00000220
00321000
00300000c
11100000
20000000
01100000
00150000
00010000
00002000
00000111c
00000505
00002000
00110000
03100000
50000000
60000600
00500000
00050000
00022000
00001111
00000000
00000220
00000005
10202000
11000000
11100111c
22000022
55500555c
00000000
11100111
22111122c
33000333
00000000
00000000
00000000c
00000000
00000000
00000000
00000000
00002000
00000000c