00000000
00000000c
00000000
00000000
00000000c
00000000
01001000c
00000000
01001000c
10000001
00000000
00000000c
00000000
51000015
00000000
00000000
10101100c
00000000
00000000
ege00000c
00000000
000000gec
00000000
01020010
00000000
00200200
20000002
00000000
00011000
00000000
20000002
00000000
10100101
00000000
10000001
22000022
00000000
00022000
00000000
20000002
00011000
00000000
20000002
00000000
02100120
00011000
00000000
00000000p
0000000k
00000000
01100110
00000000
00000000
00200200
00000000
00000000
70000007
00000000
00200200
00000000
00300300
00000000
00300300
00000000
00011000
00000000
00000005
00300300
00000000
10100101
00000000
20000002
00000000
10100101
00000000
00000000
00300300
00000000
00300300
07000010
00000000
00000000
01000007
00000000
00000000p
00000000
40000000
00000000
00000000
00000000
00000004
00000000
00000000
00000000
00022000
00000000
07000070
00000000
00303000
00000000
00000000
00000000p
00000000c
00000000
00000000
b1