00000000
00000000c
00000000
00000000
00010000c
00010000
00000000
00010010
00000000
10000001
00011000
00000000c
00011000
00000000
00011000
10000001
00000000
11000011c
11000011
01000010
00000000
10000001
00000000
00011000
00100100
00000000
21000012
00000000
00011000
01100110
01100110c
10010001
01000010
10120000
00100101
00000000
00011000c
20000002
00011000
10000001
10000001
00011000
00011000
10000001
20000002
00011000
00000000
20020002
00000000
10000001
10000001
05000500
01000010
00000000
10100101
10000001
00000000
00000000p
00000000
00000000c
00000000
05600560
00000000
30000003
00000000
0000000f
00000000
000000ik
00000000
00000000
00000000
00000000
00000000
00000000
00000000
00000000
00000000
51100115
00000000
10000001
00000000
10100101
00000000
00000000
10000001
10100101
00000000
00022000
00000000
10100101
00000000
01000010
00000000
20000002
00000000
10100101
00000000
00000000
00200200
0000000
10100101
00000000
11000110
00000000
10100101
00000000
11000011
10100101
01000010
00000000
00000000
10100101
00000000
10100101
00000000
10100101
00000000
10100101
00000000
90000000
00000000
00000000
00000009
00000000
00000000
11000011
00000000
10100101
11100000
00100101
00011000
00011000
00000000p
00000000c
00000000
b0