00000000
00000000c
00000000
00000000c
ekg00000
00000000
000000ge
00000000
00000000c
00000000
00000000
0eeg0000
00000000
00000000
00070000c
00000000
k000000k
00000000
0000000f
00000000
00000000
00000700p
00000000
e000000k
00000000
00000000
eh000000
00000000
8000eeg8c
00000000
88000088
00000000
00000000
07008000
00000000
00000000
kg00000
00000000
00000000
00000000
000000eg
00000000
00000000
00000000
00000000
00000000
keg00000
00000000
00000000
00000800
000000eg
00000000
00000000
09000000
00000000
00000000
0000k080
00000000
00800000
00000000
00000000
00000880
00000000
00000000
keh00000
00000000
00000000
000000eg
00202000
00000000
00000000
00000000
00000000p
00000000
00000000
00000000
ke000000
00000000
00080000
00000000
00000000
000000ik
00000000
00000000
d000000d
00000000
kh00000k
00000000
f0000000
00000000
00800800
00000000
00077000
00000000
00000000
00000000
keh00000
00000000
00000000
0000000f
00000000
00800000
00000000
00000000
keh00000
00000000
00000000
00000000
00000000
00000000
00000000
00000000
00000000
00000ekg
00000000
00000000
08000000
00000000
00800000p
00000000
00000000
00080000
00000000
00000000
00088ege
00000000
00088000
00000000
00000000
f0000gke
00000000
90000009
00000000
keh00000
00000000
00000000
00000000
0f000000
00000000
00000000
40000000
00000000
f000000f
00000000
k000000k
00000000
f000000f
00000000
00000000
00000000p
00000000
00000000
b2